Title_ID,SKU
T001,SKU001
T002,SKU001
T002,SKU002
T005,SKU003
T005,SKU004
T010,SKU005
T007,SKU006
